"aa" = (/turf,/area)
"ab" = (/Tiles/Small/BridgeB/B6,/area)
"ac" = (/Tiles/Small/Bridge/B4,/area)
"ad" = (/Tiles/Small/Bridge/B5,/area)
"ae" = (/Tiles/Small/Bridge/B6,/area)
"af" = (/Tiles/Small/BridgeB/B4,/area)
"ag" = (/Tiles/Small/Bridge/B7,/area)
"ah" = (/Tiles/Small/Factory_Floor/Stairs,/Tiles/Small/Bridge/B8,/area)
"ai" = (/Tiles/Small/Bridge/B9,/area)
"aj" = (/Tiles/Small/Factory_Floor/Stairs,/area)
"ak" = (/Tiles/Small/Factory_Wall/F19,/area)
"al" = (/Tiles/Small/Factory_Wall/F20,/area)
"am" = (/Tiles/Small/Factory_Wall/F21,/area)
"an" = (/Tiles/Small/Factory_Wall/F10,/area)
"ao" = (/Tiles/Small/Factory_Wall/F23,/area)
"ap" = (/Tiles/Small/Factory_Wall/F23,/Tiles/Small/Factory_Wall/F10,/area)
"aq" = (/Tiles/Small/Factory_Wall/F23,/Tiles/Small/Factory_Wall/F5,/area)
"ar" = (/Tiles/Small/Factory_Wall/F5,/area)
"as" = (/Tiles/Small/Factory_Wall/F17,/area)
"at" = (/Tiles/Small/Factory_Wall/F17,/Tiles/Small/Factory_Wall/F10,/area)
"au" = (/Tiles/Small/Factory_Wall/F17,/Tiles/Small/Factory_Wall/F5,/area)
"av" = (/Tiles/Small/Factory_Wall/F14,/area)
"aw" = (/Tiles/Small/Factory_Wall/F14,/Tiles/Small/Factory_Wall/F10,/area)
"ax" = (/Tiles/Small/Factory_Wall/F14,/Tiles/Small/Factory_Wall/F5,/area)
"ay" = (/Tiles/Small/Factory_Floor,/area)
"az" = (/Tiles/Small/Factory_Floor,/Tiles/Acid_Shilo,/Tiles/Acid_Shilo/Top,/area)
"aA" = (/Tiles/Small/Factory_Floor,/Tiles/Large/AC_Unit,/area)
"aB" = (/Tiles/Small/Factory_Wall/F17,/Tiles/Small/Factory_Wall/F27,/area)
"aC" = (/Tiles/Small/Factory_Wall/F17,/Tiles/Small/Factory_Wall/F29,/area)
"aD" = (/Tiles/Small/Factory_Floor,/Tiles/Small/Bridge,/area)
"aE" = (/Tiles/Small/Factory_Floor,/Tiles/Small/Bridge/B2,/area)
"aF" = (/Tiles/Small/Factory_Floor,/Tiles/Small/Bridge/B3,/area)
"aG" = (/Tiles/Small/Factory_Floor/F4,/area)
"aH" = (/Tiles/Small/Factory_Wall/F17,/Tiles/Small/Factory_Wall/F25,/area)
"aI" = (/Tiles/Small/Factory_Wall/F17,/Tiles/Small/Factory_Wall/F26,/area)
"aJ" = (/Tiles/Small/Factory_Wall/F23,/Tiles/Small/Bridge/B4,/area)
"aK" = (/Tiles/Small/Factory_Wall/F23,/Tiles/Small/Bridge/B5,/area)
"aL" = (/Tiles/Small/Factory_Wall/F23,/Tiles/Small/Bridge/B6,/area)
"aM" = (/Tiles/Small/Factory_Wall/F14,/Tiles/Small/Factory_Wall/F25,/area)
"aN" = (/Tiles/Small/Factory_Wall/F14,/Tiles/Large/Grate,/area)
"aO" = (/Tiles/Small/Factory_Wall/F14,/Tiles/Small/Factory_Wall/F26,/area)
"aP" = (/Tiles/Small/Factory_Floor,/Tiles/Small/Factory_Wall/F26,/area)
"aQ" = (/Tiles/Small/Factory_Wall/F17,/Tiles/Small/Bridge/B4,/area)
"aR" = (/Tiles/Small/Factory_Wall/F17,/Tiles/Small/Bridge/B5,/area)
"aS" = (/Tiles/Small/Factory_Wall/F17,/Tiles/Small/Bridge/B6,/area)
"aT" = (/Tiles/Small/Factory_Wall/F11,/Tiles/Small/Acid/A5,/Tiles/Small/Factory_Wall/F25,/area)
"aU" = (/Tiles/Small/Factory_Wall/F11,/Tiles/Small/Acid/A5,/area)
"aV" = (/Tiles/Small/Factory_Wall/F11,/Tiles/Small/Acid/A5,/Tiles/Small/Factory_Wall/F26,/area)
"aW" = (/Tiles/Medium/AmmoCrate,/Tiles/Small/Factory_Floor,/area)
"aX" = (/Tiles/Small/Factory_Wall/F14,/Tiles/Small/Bridge/B4,/area)
"aY" = (/Tiles/Small/Factory_Wall/F14,/Tiles/Small/Bridge/B5,/area)
"aZ" = (/Tiles/Small/Factory_Wall/F14,/Tiles/Small/Bridge/B6,/area)
"ba" = (/Tiles/Small/Acid/A2,/Tiles/Small/Factory_Wall/F25,/area)
"bb" = (/Tiles/Small/Acid/A2,/area)
"bc" = (/Tiles/Small/Acid/A2,/Tiles/Small/Factory_Wall/F26,/area)
"bd" = (/Tiles/Small/Factory_Wall/F11,/Tiles/Small/Acid/A5,/Tiles/Small/Bridge/B4,/area)
"be" = (/Tiles/Small/Factory_Wall/F11,/Tiles/Small/Acid/A5,/Tiles/Small/Bridge/B5,/area)
"bf" = (/Tiles/Small/Factory_Wall/F11,/Tiles/Small/Acid/A5,/Tiles/Small/Bridge/B6,/area)
"bg" = (/Tiles/Small/Acid/A2,/Tiles/Small/Bridge/B4,/area)
"bh" = (/Tiles/Small/Acid/A2,/Tiles/Small/Bridge/B5,/area)
"bi" = (/Tiles/Small/Acid/A2,/Tiles/Small/Bridge/B6,/area)
"bj" = (/Tiles/Small/Factory_Floor,/Tiles/Small/Factory_Wall/F27,/area)
"bk" = (/Tiles/Small/Factory_Floor,/Tiles/Small/Factory_Wall/F28,/area)
"bl" = (/Tiles/Small/Factory_Floor,/Tiles/Small/Factory_Wall/F28,/Tiles/Small/Bridge/B4,/area)
"bm" = (/Tiles/Small/Factory_Floor,/Tiles/Small/Factory_Wall/F28,/Tiles/Small/Bridge/B5,/area)
"bn" = (/Tiles/Small/Factory_Floor,/Tiles/Small/Factory_Wall/F28,/Tiles/Small/Bridge/B6,/area)
"bo" = (/Tiles/Small/Factory_Floor,/Tiles/Small/Factory_Wall/F25,/area)
"bp" = (/Tiles/Small/Factory_Floor,/Tiles/Small/Bridge/B7,/area)
"bq" = (/Tiles/Small/Factory_Floor,/Tiles/Small/Bridge/B8,/area)
"br" = (/Tiles/Small/Factory_Floor,/Tiles/Small/Bridge/B9,/area)
"bs" = (/Tiles/Small/Factory_Wall/F24,/area)
"bt" = (/Tiles/Small/Factory_Wall/F22,/area)
"bu" = (/Tiles/Small/Factory_Wall/F28,/Tiles/Small/Bridge/B4,/area)
"bv" = (/Tiles/Small/Factory_Wall/F28,/Tiles/Small/Bridge/B5,/area)
"bw" = (/Tiles/Small/Factory_Wall/F28,/Tiles/Small/Bridge/B6,/area)
"bx" = (/Tiles/Small/Factory_Floor,/Tiles/Small/Factory_Wall/F29,/area)
"by" = (/Tiles/Small/Factory_Wall,/area)
"bz" = (/Tiles/Small/Factory_Wall/F2,/area)
"bA" = (/Tiles/Small/Factory_Wall/F3,/area)

(1,1,1) = {"
aaaaaaaaaaaaaaaaaaaaaaaaaaaaaaaaaaaaaaaaaaaaaaaaaaaaaaaaaaaaaaaaaaaaaaaaaaaaaaaaaaaaaaaaaaaaaaaaaaaaaaaaaaaaaaaaaaaaaaaaaaaaaaaaaaaaaaaaaaaaaaaaaaaaaaaaaaaaaaaaaaaaaaaaaaaaaaaaaaaaaaaaaaaaaaaaaaaaaaaa
aaaaaaaaaaaaaaaaaaaaaaaaaaaaaaaaaaaaaaaaaaaaaaaaaaaaaaaaaaaaaaaaaaaaaaaaaaaaaaaaaaaaaaaaaaaaaaaaaaaaaaaaaaaaaaaaaaaaaaaaaaaaaaaaaaaaaaaaaaaaaaaaaaaaaaaaaaaaaaaaaaaaaaaaaaaaaaaaaaaaaaaaaaaaaaaaaaaaaaaa
aaaaaaaaaaaaaaaaaaaaaaabababababababababaaaaaaaaaaaaaaaaaaaaaaaaaaaaaaaaaaaaaaaaaaaaaaaaaaaaaaaaaaaaaaaaaaabababababababababababababababababababababababababababababababababababababababababaaaaaaaaaaaa
aaaaaaaaaaaaaaaaaaaaacadadadadadadadadadaaaaaaaaaaaaaaaaaaaaaaaaaaaaaaaaaaaaaaaaaaaaaaaaaaaaaaaaaaaaaaaaadadadadadadadadadadadadadadadadadadadadadadadadadadadadadadadadadadadadadadadadadadaeaaaaaaaaaa
aaaaaaaaaaaaaaaaaaaaacadadadadadadadadadaaababababababababababababababababababababababababababababababaaadadadadadadadadadadadadadadadadadadadadadadadadadadadadadadadadadadadadadadadadadadaeaaaaaaaaaa
aaaaaaaaaaaaaaaaaaaaacadadadadadadadadadadadadadadadadadadadadadadadadadadadadadadadadadadadadadadadadadadadadadadadadadadadadafafafafafafafafafafafafafafafafafafafafafafafafafafafafadadadaeaaaaaaaaaa
aaaaaaaaaaaaaaaaaaaaacadadadadadadadadadadadadadadadadadadadadadadadadadadadadadadadadadadadadadadadadadadadadadadadadadadadaeaaaaaaaaaaaaaaaaaaaaaaaaaaaaaaaaaaaaaaaaaaaaaaaaaaaaaaaaacadadaeaaaaaaaaaa
aaaaaaaaaaaaaaaaaaaaacadadadafafafafafafafafafafafafafafafafafafafafafafafafafafafafafafafafafafafafafafafafafafafafafafafafaaaaaaaaaaaaaaaaaaaaaaaaaaaaaaaaaaaaaaaaaaaaaaaaaaaaaaaaaaacadadaeaaaaaaaaaa
aaaaaaaaaaaaaaaaaaaaacadadaeaaaaaaaaaaaaaaaaaaaaaaaaaaaaaaaaaaaaaaaaaaaaaaaaaaaaaaaaaaaaaaaaaaaaaaaaaaaaaaaaaaaaaaaaaaaaaaaaaaaaaaaaaaaaaaaaaaaaaaaaaaaaaaaaaaaaaaaaaaaaaaaaaaaaaaaaaaagahahaiaaaaaaaaaa
aaaaaaaaaaaaaaaaaaaaagahahaiaaaaaaaaaaaaaaaaaaaaaaaaaaaaaaaaaaaaaaaaaaaaaaaaaaaaaaaaaaaaaaaaaaaaaaaaaaaaaaaaaaaaaaaaaaaaaaaaaaaaaaaaaaaaaaaaaaaaaaaaaaaaaaaaaaaaaaaaaaaaaaaaaaaaaaaaaaaaajajaaaaaaaaaaaa
aaaaaaaaaaaaaaaaaaaaaaajajaaaaaaaaaaaaaaaaaaaaaaaaaaaaaaaaaaaaaaaaaaaaaaaaaaaaaaaaaaaaaaaaaaaaaaaaaaaaaaaaaaaaaaaaaaaaaaaaaaaaaaaaaaaaaaaaaaaaaaaaaaaaaaaaaaaaaaaaaaaaaaaaaaaaaaaaaaaaaaajajaaaaaaaaaaaa
aaaaaaaaaaaaaaaaaaaaaaajajaaaaaaaaaaaaaaaaaaaaaaaaaaaaaaaaaaaaaaaaaaaaaaaaaaaaaaaaaaaaaaaaaaaaaaaaaaaaaaaaaaaaaaaaaaaaaaaaaaaaaaaaaaaaaaaaaaaaaaaaaaaaaaaaaaaaaaaaaaaaaaaaaaaaaaaaaaaaaaajajaaaaaaaaaaaa
aaaaaaaaaaaaaaaaaaaaaaajajaaaaaaaaaaaaaaaaaaaaaaaaaaaaaaaaaaaaaaaaaaaaaaaaaaaaaaaaaaaaaaaaaaaaaaaaaaaaaaaaaaaaaaaaaaaaaaaaaaaaaaaaaaaaaaaaaaaaaaaaaaaaaaaaaaaaaaaaaaaaaaaaaaaaaaaaaaaaaaajajaaaaaaaaaaaa
aaaaaaaaaaaaaaaaaaaaaaajajaaaaaaaaaaaaaaaaaaaaaaaaaaaaaaaaaaaaaaaaaaaaaaaaaaaaaaaaaaaaaaaaaaaaaaaaaaaaaaaaaaaaaaaaaaaaaaaaaaaaaaaaaaaaaaaaaaaaaaaaaaaaaaaaaaaaaaaaaaaaaaaaaaaaaaaaaaaaaaajajaaaaaaaaaaaa
aaaaaaaaaaaaaaaaaaaaaaajajaaaaaaaaaaaaaaaaaaaaaaaaaaaaaaaaaaaaaaaaaaaaaaaaaaaaaaaaaaaaaaaaaaaaaaaaaaaaaaaaaaaaaaaaaaaaaaaaaaaaaaaaaaaaaaaaaaaaaaaaaaaaaaaaaaaaaaaaaaaaaaaaaaaaaaaaaaaaaaajajaaaaaaaaaaaa
akalalalalalalalalalalajajalalalalalalalalalalalalalalalalalalalalalalalalalalalalalalalalalalalalalalalalalalalalalalalalalalalalalalalalalalalalalalalalalalalalalalalalalalalalalalalajajalalalalalam
anaoaoaoaoaoaoaoaoaoapajajaqaoaoaoaoaoaoaoaoaoaoaoaoaoaoaoaoaoaoaoaoaoaoaoaoaoaoaoaoaoaoaoaoaoaoaoaoaoaoaoaoaoaoaoaoaoaoaoaoaoaoaoaoaoaoaoaoaoaoaoaoaoaoaoaoaoaoaoaoaoaoaoaoaoaoaoaoaoapajajaqaoaoaoaoar
anasasasasasasasasasatajajauasasasasasasasasasasasasasasasasasasasasasasasasasasasasasasasasasasasasasasasasasasasasasasasasasasasasasasasasasasasasasasasasasasasasasasasasasasasasasatajajauasasasasar
anasasasasasasasasasatajajauasasasasasasasasasasasasasasasasasasasasasasasasasasasasasasasasasasasasasasasasasasasasasasasasasasasasasasasasasasasasasasasasasasasasasasasasasasasasasatajajauasasasasar
anavavavavavavavavavawajajaxavavavavavavavavavavavavavavavavavavavavavavavavavavavavavavavavavavavavavavavavavavavavavavavavavavavavavavavavavavavavavavavavavavavavavavavavavavavavavawajajaxavavavavar
anayayayayayayayayayayayayayayayayayayayayayayayayayayayayayayayayayayayayayayayayayayayayayayayayayayayayayayayayayayayayayayayayayayayayayayayayayayayayayayayayayayayayayayayayayayayayayayayayayayar
anazayayayayayayayayayayayayayayayayayayayayayayayayayayayayayayayayayayayayayayayaAayayayayazayayayayayayayayayayayayayayayayayayayayayayayayayayayayayayayayayayayayayayayayayayayayayayayayayayayayar
anayayayayayazayayayayayayayayayayayayayayayayayayayayayayayayayayayayayayayayayayayayayayayayayayayayayayayayayayayayayayayayayayayayayayayayayayayayayayayayayayayayayayayayayayayayayayayayayayayayar
anayayayayayayayayayayayayayayayayayayayayayayayayayayayayayayayayayayayayayayayayayayayayayayayayayayayayayayayayayayayayayayayayayayayayayayayayayayayayayayayayayayayayayayayayayayayayayayayayayayar
anayayayayayayayayayayayayayayayayayayayayayayayayayayayayayayayayayayayayayayayayayayayayayayayayayayayayayayayayayayayayayayayayayayayayayayayayayayayayayayayayayayayayayayayayayayayayayayayayayayar
anayayayayayayayayayayayayayayayayayayayayayayayayayayayayayayayayayayayayayayayayayayayayayayayayayayayayayayayayayayayayayayayayayayayayayayayayayayayayayayayayayayayayayayayayayayayayayayayayayayar
anayayayayayayayayayayayayayayayayayayayayayayayayayayayayayayayayayayayaBaoaoaoaoaCayayayayayayayayayayayayayayayayayayayayayayayayayayayayayayayayayayayayayayayayayayayayayayayayaDaEaEaEaEaEaFayayar
anayayayayayayayayayayaGayayayayayayayayayayayayayayayayayayayayayayayayaHasasasasaIayayayayayayayayayayayayayayayayayayayayayayayayayayayayayayayayayayayayayayaoaoaoaoaoaoaoaoaoaoaJaKaKaKaKaKaLaoaoar
anayayayayayayayayayayayayayayayayayayayayayayayayayayayayayayayayayayayaMaNavavavaOayayayayayayayayayayayayayayayayayayayayayayayayayayayayayayayayayayayayayaPasasasasasasasasasasaQaRaRaRaRaRaSasasar
anayayayayayayayayayayayayayayayayayayayayayayayayayayayayayayayayayayayaTaUaUaUaUaVayayayayayayayayayayayayayayayayaWayayayayayayayayayayayayayayayayayayayayaPavavavavaNavavavavavaXaYaYaYaYaYaZavavar
anayayayayayayayayayayayayayayayayayayayayayayayayayayayayayayayayayayaybabbbbbbbbbcayayayayayayayayayayayayayayayayayayayayayayayayayayayayayayayayayayayayayaPaUaUaUaUaUaUaUaUaUaUbdbebebebebebfaUaUar
anayayayayayayayayayayayayayayayayayayayayayayayayayayayayayayayayayayaybabbbbbbbbbcayayayayayayayayayayayayayayayayayayayayayayayayayayayayayayayayayayayayayaPbbbbbbbbbbbbbbbbbbbbbgbhbhbhbhbhbibbbbar
anayayayayayayayayayayayayayayayayayayayayayayayayayayayayayayayayayayaybabbbbbbbbbcayayayayayayayayayayayayayayayayayayayayayayayayayayayayayayayayayayayayayaPbbbbbbbbbbbbbbbbbbbbbgbhbhbhbhbhbibbbbar
anayayayayayayayayayayayayayayayayayayayayayayayayayayayayayayayayayayaybabbbbbbbbbcayayayayayayayayayayayayayayayayayayayayayayayayayayayayayayayayayayayayayaPbbbbbbbbbbbbbbbbbbbbbgbhbhbhbhbhbibbbbar
anayayayayayayayayayayayayayayayayayayayayayayayayayayayayayayayayayayaybabbbbbbbbbcayayayayayayayayayayayayayayayayayayayayayayayayayayayayayayayayayazayayayaPbbbbbbbbbbbbbbbbbbbbbgbhbhbhbhbhbibbbbar
anazayayayayayayayayayayayayayayayayayayayayayayayayayayayayayayayayayaybabbbbbbbbbcayayayayayayayayayayayayayayayayayayayayayayayayayayayayayayayayayayayayayaPbbbbbbbbbjbkbkbkbkbkblbmbmbmbmbmbnbkbkar
anayayayayayayayayayayayayayayayayayayayayayayayayayayayayayayayayayayaybabbbbbbbbbcayayayayayayayayayayayayayayayayayayayayayayayayayayayayayayayayayayayayayaPbbbbbbbbboaAayayayaybpbqbqbqbqbqbrayayar
anayayayayayayayayayayayayayayayayayayayayayayayayayayayayayayayayayayaybabbbbbbbbbcayayayayayayayayayayayayayayayayayayayayayayayayayayayayayayayayayayayayayaPbbbbbbbbboayayayayayayayayayayayayayayar
anayayayayayayayayayayayayayayayayayayayayayayayayayayayayayayayayayayaybabbbbbbbbbcayayayayayayayayayayayayayayayayayayaGayayayayazayayayayayayayayayayayayayaPbbbbbbbbboayayayayayayayayayayayayayayar
anayayayayayayayayayayayayayayayayayayayayayayayayayayayayayayayayayayaybabbbbbbbbbcayayayayayayayayayayayayayayayayayayayayayayayayayayayayayayayayayayayayayaPbbbbbbbbboayayayayayayayayayayayayayayar
anayayayayayayayayayayaDaEaEaEaEaEaEaFayayayayayayayayayazayayayayayayaybabbbbbbbbbcayayayayayayayayayayayayayayayayayayayayayayayayayayazayayayayayayayayayayaPbbbbbbbbboayayayayayaDaEaEaEaEaEaFayayar
anaoaoaoaoaoaoaoaoaoaoaJaKaKaKaKaKaKaLaoaoaoaoaoaoaoaoaoaoaoaoaoaoaoaoaobbbbbbbbbbbbaoaoaoaoaoaoaoaoaoaoaoaoaoaoaoaoaoaoaoaoaoaoaoaoaoaoaoaoaoaoaoaoaoaoaoaoaobsbbbbbbbbbtaoaoaoaoaoaJaKaKaKaKaKaLaoaoar
anasasasasasasasasasasaQaRaRaRaRaRaRaSasasasasasasasasasasasasasasasasasbbbbbbbbbbbbasasasasasasasasasasasasasasasasasasasasasasasasasasasasasasasasasasasasasasbbbbbbbbasasasasasasaQaRaRaRaRaRaSasasar
anavaNavavavavavavavavaXaYaYaYaYaYaYaZavavavavavavavavavavavavavavavavavbbbbbbbbbbbbavavavavavavavavavavavavavavavavavavavavavavavavavavavavavavavavavavavavavavbbbbbbbbavavavavavavaXaYaYaYaYaYaZavavar
anaUaUaUaUaUaUaUaUaUaUbdbebebebebebebfaUaUaUaUaUaUaUaUaUaUaUaUaUaUaUaUaUbbbbbbbbbbbbaUaUaUaUaUaUaUaUaUaUaUaUaUaUaUaUaUaUaUaUaUaUaUaUaUaUaUaUaUaUaUaUaUaUaUaUaUaUbbbbbbbbaUaUaUaUaUaUbdbebebebebebfaUaUar
anbbbbbbbbbbbbbbbbbbbbbgbhbhbhbhbhbhbibbbbbbbbbbbbbbbbbbbbbbbbbbbbbbbbbbbbbbbbbbbbbbbbbbbbbbbbbbbbbbbbbbbbbbbbbbbbbbbbbbbbbbbbbbbbbbbbbbbbbbbbbbbbbbbbbbbbbbbbbbbbbbbbbbbbbbbbbbbbbbbgbhbhbhbhbhbibbbbar
anbbbbbbbbbbbbbbbbbbbbbgbhbhbhbhbhbhbibbbbbbbbbbbbbbbbbbbbbbbbbbbbbbbbbbbbbbbbbbbbbbbbbbbbbbbbbbbbbbbbbbbbbbbbbbbbbbbbbbbbbbbbbbbbbbbbbbbbbbbbbbbbbbbbbbbbbbbbbbbbbbbbbbbbbbbbbbbbbbbgbhbhbhbhbhbibbbbar
anbbbbbbbbbbbbbbbbbbbbbgbhbhbhbhbhbhbibbbbbbbbbbbbbbbbbbbbbbbbbbbbbbbbbbbbbbbbbbbbbbbbbbbbbbbbbbbbbbbbbbbbbbbbbbbbbbbbbbbbbbbbbbbbbbbbbbbbbbbbbbbbbbbbbbbbbbbbbbbbbbbbbbbbbbbbbbbbbbbgbhbhbhbhbhbibbbbar
anbbbbbbbbbbbbbbbbbbbbbgbhbhbhbhbhbhbibbbbbbbbbbbbbbbbbbbbbbbbbbbbbbbbbbbbbbbbbbbbbbbbbbbbbbbbbbbbbbbbbbbbbbbbbbbbbbbbbbbbbbbbbbbbbbbbbbbbbbbbbbbbbbbbbbbbbbbbbbbbbbbbbbbbbbbbbbbbbbbgbhbhbhbhbhbibbbbar
anbbbbbbbbbbbbbbbbbbbbbgbhbhbhbhbhbhbibbbbbbbbbbbbbbbbbbbbbbbbbbbbbbbbbbbbbbbbbbbbbbbbbbbbbbbbbbbbbbbbbbbbbbbbbbbbbbbbbbbbbbbbbbbbbbbbbbbbbbbbbbbbbbbbbbbbbbbbbbbbbbbbbbbbbbbbbbbbbbbgbhbhbhbhbhbibbbbar
anbbbbbbbbbbbbbbbbbbbbbgbhbhbhbhbhbhbibbbbbbbbbbbbbbbbbbbbbbbbbbbbbbbbbbbbbbbbbbbbbbbbbbbbbbbbbbbbbbbbbbbbbbbbbbbbbbbbbbbbbbbbbbbbbbbbbbbbbbbbbbbbbbbbbbbbbbbbbbbbbbbbbbbbbbbbbbbbbbbgbhbhbhbhbhbibbbbar
anbbbbbbbbbbbbbbbbbbbbbgbhbhbhbhbhbhbibbbbbbbbbbbbbbbbbbbbbbbbbbbbbbbbbbbbbbbbbbbbbbbbbbbbbbbbbbbbbbbbbbbbbbbbbbbbbbbbbbbbbbbbbbbbbbbbbbbbbbbbbbbbbbbbbbbbbbbbbbbbbbbbbbbbbbbbbbbbbbbgbhbhbhbhbhbibbbbar
anbbbbbbbbbbbbbbbbbbbbbgbhbhbhbhbhbhbibbbbbbbbbbbbbbbbbbbbbbbbbbbbbbbbbbbbbbbbbbbbbbbbbbbbbbbbbbbbbbbbbbbbbbbbbbbbbbbbbbbbbbbbbbbbbbbbbbbbbbbbbbbbbbbbbbbbbbbbbbbbbbbbbbbbbbbbbbbbbbbgbhbhbhbhbhbibbbbar
anbbbbbbbbbbbbbbbbbbbbbgbhbhbhbhbhbhbibbbbbbbbbbbbbbbbbbbbbbbbbbbbbbbbbbbbbbbbbbbbbbbbbbbbbbbbbbbbbbbbbbbbbbbbbbbbbbbbbbbbbbbbbbbbbbbbbbbbbbbbbbbbbbbbbbbbbbbbbbbbbbbbbbbbbbbbbbbbbbbgbhbhbhbhbhbibbbbar
anbbbbbbbbbbbbbbbbbbbbbgbhbhbhbhbhbhbibbbbbbbbbbbbbbbbbbbbbbbbbbbbbbbbbbbbbbbbbbbbbbbbbbbbbbbbbbbbbbbbbbbbbbbbbbbbbbbbbbbbbbbbbbbbbbbbbbbbbbbbbbbbbbbbbbbbbbbbbbbbbbbbbbbbbbbbbbbbbbbgbhbhbhbhbhbibbbbar
anbkbkbkbkbkbkbkbkbkbkbubvbvbvbvbvbvbwbkbkbkbkbkbkbkbkbkbkbkbkbkbkbkbkbkbkbkbkbkbkbkbkbkbkbkbkbkbkbkbkbkbkbkbkbkbkbkbkbkbkbkbkbxbbbbbbbbbjbkbkbkbkbkbkbkbkbkbkbkbkbkbkbkbkbkbkbkbkbkblbmbmbmbmbmbnbkbkar
anayayayayayayayayayaybpbqbqbqbqbqbqbrayayayayayayayayayayayayayayayayayayayayayayayayayayayayayayayayayayayayayayayayayayayayaPbbbbbbbbboayayayayayayayayayayayayayayayayayayayayaybpbqbqbqbqbqbrayayar
anaAayayayayayayayayayayayayayayayayayayayayayayayayayayayayayayayayayayayayazayayayayayayayayayayayayayayayayazayayayazayayayaPbbbbbbbbboayazayayayayayayayayayayayayayayayayayayayayayayayayayayayayar
anayayayayayayayayayayayayayayayayayayayayayayayayayayayayayayayayayayayayayayayayayayayayayayayayayayayayayayayayayayayayayayaPbbbbbbbbboayayayayayayazayayayayayayayayayayayayayayayayayayayayayayayar
anayayayayayayayayayayayayayayayayayayayayayayayayayayayayayayayayayayayayayayayayayayayayayayayayayayayayayayayayayayayayayayaPbbbbbbbbboayayayayayayayayayayayayayayayayayayayayayayayayayayayayayayar
anayayayayayayayayayayayayayayayayayayayayayayayayayayayayayayayayayayayayayayayayayayayayayayayayayayayayayayayayayayayayayayaPbbbbbbbbboayayayayayayayayayayayayayayayayayayayayayayayayayayayayayayar
anayayayayayayayayayayayayayayayayayayayayayayayayayayayayayayayayayayayayayayayayayayayayayayayayayayayayayayayayayayayayayayaPbbbbbbbbboayayayayayayayayayayayayayayayayayayayayayayayayayayayayayayar
anayayayayayayayayayayayayayayayayayayayayayayayayayayayayayayayayayayayayayayayayayayayayayayayayayayayayayayayayayayayayayayaPbbbbbbbbboayayayayayayayayayayayayayayayayayayayayayayayayayayayayayayar
anayayayazayayayayayayayayayayayayayayayayayayayayayayayayayayayayayayayayayayayayayayayayayayayayayayayayayayayayayayayayayayaPbbbbbbbbboayayayayayayayayayayayayayayayayayayayayayayayayayayayayayayar
anayayayayayayayayayayayayayayayayayayayayayayayayayayayayayayayayayayayayayayayayayayayayayayayayayayayayayayayayayayayayayayaPbbbbbbbbboayayayayayayayayayayayayayayayayayayayayayayayayayayayayayayar
anayayayayayayayayayayayayayayayayayayayayayayayayayayayayayayayayayayayayayayayayayayayayayayayayayayayayayayayayayayayayayayaPbbbbbbbbboayayayayayayayayayayayayayayayayayayayaGayayayayayayayayayayar
anayayayayayayayayayayayayayayayayayayayayayayayayayaGayayayayayayayayayayayayayayayayayayayayayayayayayayayayayaAayayayayayayaPbbbbbbbbboayayayayayayayayayayayayayayayayayayayayayayayayayayayayayayar
anayayayayayayayayayayayayayayayayayayayayayayayayayayayayayayayayayayayayayayayaBaoaoaoaoaoaoaoaoaoaoaoaoaoaoaoaoaoaoaoaoaoaobsbbbbbbbbboayayayayayayayayayayayayayayayayayayayayayayayayayayayayayayar
anayayayayayayayayayayayayayayayayayayayayayayayayayayayayayayayayayayayayayayayaHasasasasasasasasasasasasasasasasasasasasasasasbbbbbbbbboayayayayayayayayayayayayayayayayayayayayayayayayayayayayayayar
anayayayayayayayayayayayayayayayayayayayayayayayayayayayayayayayayayayayayayayayaMavavavavavavavavavavavaNavavavavavavavavavavavbbbbbbbbboayayayayayayayayayayayayayayayayayayayayayayayayayayayayayayar
anayayayayayayayayayayayayayayayayayayayayayayayayayayayayayayayayayayayayayayayaTaUaUaUaUaUaUaUaUaUaUaUaUaUaUaUaUaUaUaUaUaUaUaUbbbbbbbbboayayayayayayayayayayayayayayayayayayayayayayayayayayayayayayar
anayayayayayayayayayayayayayayayayayayayayayayayayayayayayayayayayayayayayayayaybabbbbbbbbbbbbbbbbbbbbbbbbbbbbbbbbbbbbbbbbbbbbbbbbbbbbbbboayayayayayayayayayayayayayayayayayayayayayayayayayayayayayayar
anayayayayayayayayayayayayayayayayayayayayayayayayayayayayayayayayayayayayayayaybabbbbbbbbbbbbbbbbbbbbbbbbbbbbbbbbbbbbbbbbbbbbbbbbbbbbbbboayayayayayayayayayayayayayayayayayayayayayayayayayayayayayayar
anayayayayayayayayayayayayayayayayayayayayayayayayayayayayayayayayayayayayayayaybabbbbbbbbbbbbbbbbbbbbbbbbbbbbbbbbbbbbbbbbbbbbbbbbbbbbbbboayayayayayayayayayayayayayayayayayayayayayayayayayayayayayayar
anayayayayayayayayayayayayayayayayayayayayayayayayayayayayayayayayayayayayayayaybabbbbbbbbbbbbbbbbbbbbbbbbbbbbbbbbbbbbbbbbbbbbbbbbbbbbbbboayayayayayayayayayayayayayayayayayayayayayayayayayayayayayayar
anayayayayayayayayayayayayayayayayayayayayayayayayayayayayayayayayayayayayayayaybkbkbkbkbkbkbkbkbkbkbkbkbkbkbkbkbkbkbkbkbkbkbkbkbkbkbkbkayayayayayayayayayayayayayayayayayayayayayayayayayayayayayayayar
anayayayayayayayayayayayayayayayayayayayayayayayayayayayayayayayayayayayayayayayayayayayayayayayayayayayayayayayayayayayayayayayayayayayayayayayayayayayayayayayayayayayayayayayayayayayayayayayayayayar
anayayayayayayayayayayayayayayayayayayayayayayayayayayayayayayayayayayayayayayayayayayayayayayayayayayayayayayayayayayayayayayayayayayayayayayayayayayayayayayayayayayayayayayayayayayazayayayayayayayar
anazayayayayayayayayayayayayayayayayayayayayayayayayayayayayayayayayayayayayayayayayayayayayayayayayayayayayayayayayayayayayayayayayayayayayayayayayayayayayayayayayayayayayayayayayayayayayayayayayayar
anayayayayayayayayayayayayayayayayayayayayayayayayayayayayayayayayayayayayayayayayayayayayayayayayayayayayayayayayayayayayayayayayayayayayayayayayayayayayayayayayayayayayayayayayayayayayayayayayayayar
bybzbzbzbzbzbzbzbzbzbzbzbzbzbzbzbzbzbzbzbzbzbzbzbzbzbzbzbzbzbzbzbzbzbzbzbzbzbzbzbzbzbzbzbzbzbzbzbzbzbzbzbzbzbzbzbzbzbzbzbzbzbzbzbzbzbzbzbzbzbzbzbzbzbzbzbzbzbzbzbzbzbzbzbzbzbzbzbzbzbzbzbzbzbzbzbzbzbzbA
aaaaaaaaaaaaaaaaaaaaaaaaaaaaaaaaaaaaaaaaaaaaaaaaaaaaaaaaaaaaaaaaaaaaaaaaaaaaaaaaaaaaaaaaaaaaaaaaaaaaaaaaaaaaaaaaaaaaaaaaaaaaaaaaaaaaaaaaaaaaaaaaaaaaaaaaaaaaaaaaaaaaaaaaaaaaaaaaaaaaaaaaaaaaaaaaaaaaaaaa
aaaaaaaaaaaaaaaaaaaaaaaaaaaaaaaaaaaaaaaaaaaaaaaaaaaaaaaaaaaaaaaaaaaaaaaaaaaaaaaaaaaaaaaaaaaaaaaaaaaaaaaaaaaaaaaaaaaaaaaaaaaaaaaaaaaaaaaaaaaaaaaaaaaaaaaaaaaaaaaaaaaaaaaaaaaaaaaaaaaaaaaaaaaaaaaaaaaaaaaa
aaaaaaaaaaaaaaaaaaaaaaaaaaaaaaaaaaaaaaaaaaaaaaaaaaaaaaaaaaaaaaaaaaaaaaaaaaaaaaaaaaaaaaaaaaaaaaaaaaaaaaaaaaaaaaaaaaaaaaaaaaaaaaaaaaaaaaaaaaaaaaaaaaaaaaaaaaaaaaaaaaaaaaaaaaaaaaaaaaaaaaaaaaaaaaaaaaaaaaaa
aaaaaaaaaaaaaaaaaaaaaaaaaaaaaaaaaaaaaaaaaaaaaaaaaaaaaaaaaaaaaaaaaaaaaaaaaaaaaaaaaaaaaaaaaaaaaaaaaaaaaaaaaaaaaaaaaaaaaaaaaaaaaaaaaaaaaaaaaaaaaaaaaaaaaaaaaaaaaaaaaaaaaaaaaaaaaaaaaaaaaaaaaaaaaaaaaaaaaaaa
aaaaaaaaaaaaaaaaaaaaaaaaaaaaaaaaaaaaaaaaaaaaaaaaaaaaaaaaaaaaaaaaaaaaaaaaaaaaaaaaaaaaaaaaaaaaaaaaaaaaaaaaaaaaaaaaaaaaaaaaaaaaaaaaaaaaaaaaaaaaaaaaaaaaaaaaaaaaaaaaaaaaaaaaaaaaaaaaaaaaaaaaaaaaaaaaaaaaaaaa
aaaaaaaaaaaaaaaaaaaaaaaaaaaaaaaaaaaaaaaaaaaaaaaaaaaaaaaaaaaaaaaaaaaaaaaaaaaaaaaaaaaaaaaaaaaaaaaaaaaaaaaaaaaaaaaaaaaaaaaaaaaaaaaaaaaaaaaaaaaaaaaaaaaaaaaaaaaaaaaaaaaaaaaaaaaaaaaaaaaaaaaaaaaaaaaaaaaaaaaa
aaaaaaaaaaaaaaaaaaaaaaaaaaaaaaaaaaaaaaaaaaaaaaaaaaaaaaaaaaaaaaaaaaaaaaaaaaaaaaaaaaaaaaaaaaaaaaaaaaaaaaaaaaaaaaaaaaaaaaaaaaaaaaaaaaaaaaaaaaaaaaaaaaaaaaaaaaaaaaaaaaaaaaaaaaaaaaaaaaaaaaaaaaaaaaaaaaaaaaaa
aaaaaaaaaaaaaaaaaaaaaaaaaaaaaaaaaaaaaaaaaaaaaaaaaaaaaaaaaaaaaaaaaaaaaaaaaaaaaaaaaaaaaaaaaaaaaaaaaaaaaaaaaaaaaaaaaaaaaaaaaaaaaaaaaaaaaaaaaaaaaaaaaaaaaaaaaaaaaaaaaaaaaaaaaaaaaaaaaaaaaaaaaaaaaaaaaaaaaaaa
aaaaaaaaaaaaaaaaaaaaaaaaaaaaaaaaaaaaaaaaaaaaaaaaaaaaaaaaaaaaaaaaaaaaaaaaaaaaaaaaaaaaaaaaaaaaaaaaaaaaaaaaaaaaaaaaaaaaaaaaaaaaaaaaaaaaaaaaaaaaaaaaaaaaaaaaaaaaaaaaaaaaaaaaaaaaaaaaaaaaaaaaaaaaaaaaaaaaaaaa
aaaaaaaaaaaaaaaaaaaaaaaaaaaaaaaaaaaaaaaaaaaaaaaaaaaaaaaaaaaaaaaaaaaaaaaaaaaaaaaaaaaaaaaaaaaaaaaaaaaaaaaaaaaaaaaaaaaaaaaaaaaaaaaaaaaaaaaaaaaaaaaaaaaaaaaaaaaaaaaaaaaaaaaaaaaaaaaaaaaaaaaaaaaaaaaaaaaaaaaa
aaaaaaaaaaaaaaaaaaaaaaaaaaaaaaaaaaaaaaaaaaaaaaaaaaaaaaaaaaaaaaaaaaaaaaaaaaaaaaaaaaaaaaaaaaaaaaaaaaaaaaaaaaaaaaaaaaaaaaaaaaaaaaaaaaaaaaaaaaaaaaaaaaaaaaaaaaaaaaaaaaaaaaaaaaaaaaaaaaaaaaaaaaaaaaaaaaaaaaaa
aaaaaaaaaaaaaaaaaaaaaaaaaaaaaaaaaaaaaaaaaaaaaaaaaaaaaaaaaaaaaaaaaaaaaaaaaaaaaaaaaaaaaaaaaaaaaaaaaaaaaaaaaaaaaaaaaaaaaaaaaaaaaaaaaaaaaaaaaaaaaaaaaaaaaaaaaaaaaaaaaaaaaaaaaaaaaaaaaaaaaaaaaaaaaaaaaaaaaaaa
aaaaaaaaaaaaaaaaaaaaaaaaaaaaaaaaaaaaaaaaaaaaaaaaaaaaaaaaaaaaaaaaaaaaaaaaaaaaaaaaaaaaaaaaaaaaaaaaaaaaaaaaaaaaaaaaaaaaaaaaaaaaaaaaaaaaaaaaaaaaaaaaaaaaaaaaaaaaaaaaaaaaaaaaaaaaaaaaaaaaaaaaaaaaaaaaaaaaaaaa
aaaaaaaaaaaaaaaaaaaaaaaaaaaaaaaaaaaaaaaaaaaaaaaaaaaaaaaaaaaaaaaaaaaaaaaaaaaaaaaaaaaaaaaaaaaaaaaaaaaaaaaaaaaaaaaaaaaaaaaaaaaaaaaaaaaaaaaaaaaaaaaaaaaaaaaaaaaaaaaaaaaaaaaaaaaaaaaaaaaaaaaaaaaaaaaaaaaaaaaa
aaaaaaaaaaaaaaaaaaaaaaaaaaaaaaaaaaaaaaaaaaaaaaaaaaaaaaaaaaaaaaaaaaaaaaaaaaaaaaaaaaaaaaaaaaaaaaaaaaaaaaaaaaaaaaaaaaaaaaaaaaaaaaaaaaaaaaaaaaaaaaaaaaaaaaaaaaaaaaaaaaaaaaaaaaaaaaaaaaaaaaaaaaaaaaaaaaaaaaaa
aaaaaaaaaaaaaaaaaaaaaaaaaaaaaaaaaaaaaaaaaaaaaaaaaaaaaaaaaaaaaaaaaaaaaaaaaaaaaaaaaaaaaaaaaaaaaaaaaaaaaaaaaaaaaaaaaaaaaaaaaaaaaaaaaaaaaaaaaaaaaaaaaaaaaaaaaaaaaaaaaaaaaaaaaaaaaaaaaaaaaaaaaaaaaaaaaaaaaaaa
aaaaaaaaaaaaaaaaaaaaaaaaaaaaaaaaaaaaaaaaaaaaaaaaaaaaaaaaaaaaaaaaaaaaaaaaaaaaaaaaaaaaaaaaaaaaaaaaaaaaaaaaaaaaaaaaaaaaaaaaaaaaaaaaaaaaaaaaaaaaaaaaaaaaaaaaaaaaaaaaaaaaaaaaaaaaaaaaaaaaaaaaaaaaaaaaaaaaaaaa
aaaaaaaaaaaaaaaaaaaaaaaaaaaaaaaaaaaaaaaaaaaaaaaaaaaaaaaaaaaaaaaaaaaaaaaaaaaaaaaaaaaaaaaaaaaaaaaaaaaaaaaaaaaaaaaaaaaaaaaaaaaaaaaaaaaaaaaaaaaaaaaaaaaaaaaaaaaaaaaaaaaaaaaaaaaaaaaaaaaaaaaaaaaaaaaaaaaaaaaa
aaaaaaaaaaaaaaaaaaaaaaaaaaaaaaaaaaaaaaaaaaaaaaaaaaaaaaaaaaaaaaaaaaaaaaaaaaaaaaaaaaaaaaaaaaaaaaaaaaaaaaaaaaaaaaaaaaaaaaaaaaaaaaaaaaaaaaaaaaaaaaaaaaaaaaaaaaaaaaaaaaaaaaaaaaaaaaaaaaaaaaaaaaaaaaaaaaaaaaaa
"}
